11111111111111
10000000000001
1000000P0E0001
100000000C0001
10000C00000001
11111111111111