11111111111111
10000000000001
1000E0PC00C001
1000C000000001
10000000000001
11111111111111