11111111111111111
10000001100001001
1000E0PC00C000001
1000C000100001001
10000010001001001
11111111111111111