11111111111111
10000000000001
1000000P000001
1E00000000C001
11111111111111