1111111111
1000000001
1CPE000001
1111111111