11111111111111
10000000000001
1000000P000001
100000000C00E1
11111111111111