11111111111111111
10000000000001001
1000E0PC00C000001
1000C000000001001
10000010000001001
11111111111111111