11111111
1000P001
100C0001
11111111