11111111
1000P001
100C0E01
11111111