11111111111
10000E00001
1000C00P001
11111111111