11111111
1000Pd01
100C0E01
11111111