11101111
1P000CE1
1P000CE1
11111111