11111111
1000d001
100C0E01
11111111