11111111111
10000E0P001
1000C000011
11111111111